##########
#P       #
#  M10   #
#  V05   #
#  ####  #
#        #
##########