#####################
#P                  #
#                   #
###                 #
#    ###            #
#                   #
#                   #
#                   #
#                   #
#                 # #
#SS               #E#
#####################